NO textures/gal/gal1.xpm
SO textures/gal/gal2.xpm
WE textures/gal/gal3.xpm
EA textures/gal/gal4.xpm

F 0,0,0
C 255, 200, 200

11111
10001
10N01
10001
11111