NO textures/matrix.xpm
SO textures/matrix.xpm
WE textures/matrix.xpm
EA textures/matrix.xpm

F 0,0,0
C 0,0,0

111111111111111
100000000000001
100000000000001
1000000000000001
111111111111111
1S0000000000001
111111111111111
