NO textures/matrix.xpm
SO textures/matrix.xpm
WE textures/matrix.xpm
EA textures/matrix.xpm

F 0,0,0
C 0,0,0

1111111111111111
1000000000000001
1111111111111111
1000000000E000001
100000000000000001
100000000000000001
1111111111111111
