NO textures/matrix.xpm
SO textures/matrix.xpm
WE textures/matrix.xpm
EA textures/matrix.xpm

F 0,0,0
C 0,0,0

111111111111111
1W0000000000001
111111111111111
1001100000000001
100000010000001
1000000100100001
1111111111111111
