NO textures/gal/gal1.xpm
SO textures/gal/gal2.xpm
WE textures/gal/gal3.xpm
EA textures/gal/gal4.xpm

F 0, 191, 255
C 224, 255, 255

1111111111111111
1000000000000001
1111111111111111
1000000000W000001
100000000000000001
100000000000000001
11111111111111111
