NO textures/gal/gal1.xpm
SO textures/gal/gal2.xpm
WE textures/gal/gal3.xpm
EA textures/gal/gal4.xpm

F 255, 145, 180
C 255, 255, 255

111111111111
11000000001
1000N00001
 10000001
  111111