NO textures/gal/gal1.xpm
SO textures/gal/gal2.xpm
WE textures/gal/gal3.xpm
EA textures/gal/gal4.xpm

F 255, 145, 180
C 255, 255, 255

    1
   101
  10E01
 1000001
111111111