NO textures/gal/gal1.xpm
SO textures/gal/gal2.xpm
WE textures/gal/gal3.xpm
EA textures/gal/gal4.xpm

F 138, 43, 226
C 255, 192, 203

111111111111111111111111111
100000000000011110000000001
100000000000011110000000001
111111100000000000001111111
111111100000000000001111111
110000000000000000000000001
100000000000000000000000001
100000000000000000000000001
1000N0000011111111111111111
100000000000000000000000011
111000011000001111111100011
111111111111111111111111111