NO textures/gal/gal1.xpm
SO textures/gal/gal2.xpm
WE textures/gal/gal3.xpm
EA textures/gal/gal4.xpm

F 128, 50, 20
C 219, 112, 147

111111111111111
1100000000000001
  1000000000011
 1000000000000111
111111111100000011
11000000000000001
100S00000000001111
10000000000000001
11111111111111111
