NO textures/gal/gal1.xpm
SO textures/gal/gal2.xpm
WE textures/gal/gal3.xpm
EA textures/gal/gal4.xpm

F 255, 255, 255
C 255, 255, 255

1111111
1000001
000N001
1000001
1111111
